00000000000000000000000000000000000
01111111110011111111111001111111110
01000000010010000000001001000000010
01000000010010000000001001000000010
01111111010011111111111001011111110
00000001011111111111111111010000000
00011111111111111111111111111111000
00010000011111111111111111000001000
00010000010111111111111101000001000
01111111111111111111111111111101110
00010000010111111111111101000001000
01110000010111111111111101000001110
01000000010111111111111101000000010
01000000010111111111111101000000010
01000000010111111111111101000000010
01111111110111111111111101111111110
01000000010111111111111101000000010
01000000010111111111111101000000010
01111111111111111111111111111111110
00000000000000000000000000000000000
