00000000000000000000000000000000000
01111111111111111111111111111111110
01000000010010000000001001000000010
01000000010010000000001001000000010
01111111010011111111111001011111110
00000001011110000000001111010000000
00011111110000000000000001111111000
00010000011111111111111111000001000
00010000010000000000000001000001000
02110000011111111111111111000001120
00010000010011111111111001000001000
01110000010010000000001001000001110
01000000010010000000001001000000010
01000000010010000000001001000000010
01000000010011111111111001000000010
01111111110010000000001001111111110
01000000010010000000001001000000010
01000000010010000000001001000000010
01111111111111111111111111111111110
00000000000000000000000000000000000