21111100000000000000
00000111111110000000
00111100000000000000
00000100000000000000
00000111111111100000
00000100000000100000
00000100000000100000
00000100000000100000
00000100000000100000
00000100000000100000
00000100000000111100
00000100000000000000
00000111111111111100
00000100000000001103
00000100000000001001
00000100000000001111
00000100000000000000
00000100000000000100
00000111111111111100
00000000000000000000
