00000000000000000000
02111111111111111110
01111111111111111110
01111111111111111110
01111111111111111110
01111111111111111110
01111111111111111110
01111111111111111110
01111111111111111110
01111111111111111110
01111111111111111110
01111111111111111110
01111111111111111110
01111111111111111110
01111111111111111110
01111111111111111110
01111111111111111110
01111111111111111110
01111111111111111110
00000000000000000000
