00000000000000000000000000000000000
01111111111111111111111111111111110
02222222222222222222222222222222220
02222222222222222222222222222222220
02222222222222222222222222222222220
02222222222222222222222222222222220
02222222222222222222222222222222220
02222222222222222222222222222222220
02222222222222222222222222222222220
02222222222222222222222222222222220
02222222222222222222222222222222220
02222222222222222222222222222222220
02222222222222222222222222222222220
02222222222222222222222222222222220
02222222222222222222222222222222220
02222222222222222222222222222222220
02222222222222222222222222222222220
02222222222222222222222222222222220
02222222222222222222222222222222220
00000000000000000000000000000000000
