00000000000000000000000000000000000
01111111111111111122222222222222220
01000000010010000000002002000000020
01000000010010000000002002000000020
01111111010011111122222002022222220
00000001011110000000002222020000000
00011111110000000000000002222222000
00010000011111111122222222000002000
00010000010000000000000002000002000
02110000011111111122222222000002220
00010000010010000000002002000002000
01110000010010000000002002000002220
01000000010010000000002002000000020
01000000010010000000002002000000020
01000000010011111122222002000000020
01111111110010000000002002222222220
01000000010010000000002002000000020
01000000010010000000002002000000020
01111111111111111122222222222222220
00000000000000000000000000000000000